leParagon: All battle sprites except the ones below, QC for almost every battles sprites

N-Kin, goranthegreat, leParagon: Rowlet, Litten, Popplio
leParagon, BlackstarG5: Cosmog, Cosmoem, Marshadow (Gloomdweller)
leParagon, fishbowlsoul90: Turtonator, Solgaleo (Normal), Lunala (Normal)
leParagon, mangamanga: Yungoos, Rockruff, Guzzlord
leParagon, JaegerLucciano23: Xurkitree, Celesteela
leParagon, HeXeR: Wishiwashi (School), Drampa
leParagon, MrDollSteak: Toxapex, Alolan Raichu
Chaos Rush, leParagon: Alolan Diglett, Alolan Dugtrio, Alolan Graveler, Gigantamax Venusaur, Gigantamax Machamp, Gigantamax Kingler, Gigantamax Lapras, Gigantamax Eevee, Pikachu in a cap (All forms), Surfing Pikachu, Cosplay Pikachu (All forms), Spiky Ear Pichu
Chaos Rush, thedarkdragon11, leParagon, GPX+: Shadow Lugia, Primal Dialga

KingOfThe-X-Roads (front), leParagon (back): Blipbug, Dottler, Gossifleur, Wooloo, Dubwool
KingOfThe-X-Roads, Z-nogyroP (front), leParagon (back): Corvisquire, Thievul, Bolthund, Sandaconda, Stonjourner, Cufant, Copperajah, Dracozolt, Arctozolt
KingOfThe-X-Roads, Z-nogyroP (front), leParagon, Z-nogyroP (back): Orbeetle, Gigantamax Orbeetle
Crocovyle (front), leParagon (back): Applin, Toxel, Milcery
G.E.Z. (front), leParagon (back): Greedent, Mr. Rime, Galarian Darumaka, Galarian Darmanitan (All forms)
French-Cyndaquil, Z-nogyroP (front), leParagon (back): Clobbopus, Galarian Yamask, Zamazenta (Crowned Shield)
French-Cyndaquil: Obstagoon, Galarian Linoone
French-Cyndaquil, leParagon (front), leParagon (back): Cramorant (All forms), Runerigus, Morpeko (All forms)
leParagon, Z-nogyroP (front), leParagon (back): Arrokuda, Grapploct, Morgrem
leParagon, Z-nogyroP: Barraskewda, Sinistea, Grimmsnarl, Dracovish
Crocovyle, leParagon (front), leParagon (back): Thwackey, Raboot, Drizille, Indeedee (All forms), Kubfu
Spook, leParagon (front), leParagon (back): Carkol, Coalossal, Gigantamax Coalossal
leparagon (front, back), WolfPP (QC): Drakloak, Dragapult

Cinderace: leParagon, Blaquaza, MrDollSteak (front), leParagon (back)
Silicobra: KingOfThe-X-Roads, leParagon, Z-nogyroP (front), leParagon (back)
Toxtricity (All forms): involuntary Twitch, leParagon, Z-nogyroP (front), leParagon (back)
Sizzlipede: Zerudez, Z-nogyroP (front), Z-nogyroP (back)
Centiskorch: mjco, leParagon, Z-nogyroP (front), leParagon, Z-nogyroP (back)
Polteageist: Z-nogyroP (front), French-Cyndaquil (back)
Hatterene: leParagon, Z-nogyroP (front), leParagon (back)
Impidimp: leParagon, French-Cyndaquil, Z-nogyroP (front), leParagon, MrDollSteak (back)
Falinks: KingOfThe-X-Roads, leParagon (front), leParagon (back)
Snom: RadicalCharizard, leParagon (front), leParagon (back)
Zacian (Crowned Sword): French-Cyndaquil (front), leParagon (back)
Gigantamax Blastoise: leParagon (front), Chaos Rush, leParagon (front)
Gigantamax Garbodor: leParagon, Chaos Rush (front), leParagon, Chaos Rush, MrDollSteak (back)
Gigantamax Cinderace: leParagon, MrDollSteak (front), leParagon (back)
Galarian Ponyta: French-Cyndaquil (front), leParagon (back)
Galarian Weezing: French-Cyndaquil
Galarian ZIgzagoon: El Diabeetus (front), leParagon (back)

Decidueye: leParagon, BlackWhiteRobin
Torracat: KajiAtsui, goranthegreat, leParagon
Incineroar: leParagon, MyMarshlands
Brionne: Wobblebuns, Tetra, leParagon
Primarina: Wobblebuns, goranthegreat, leParagon
Crabrawler: Noscium, HeXeR, leParagon
Crabominable: JaegerLucciano23, Z-nogyroP, leParagon
Cutiefly: Noscium, xiechayghe, princessofmusic, Zervais, goranthegreat, leParagon
Ribombee: Z-nogyroP, goranthegreat, leParagon
Wishiwashi (Solo): Z-nogyroP (front); leParagon (back)
Dewpider: fishbowlsoul90, Trev, leParagon
Sandygast: Z-nogyroP, goranthegreat
Palossand: Z-nogyroP, Kevin RDS, goranthegreat
Togedemaru: Espeon Scientist, princessofmusic, Trev, leParagon
Mimikyu (All forms): leParagon, Trev, BlackWhiteRobin
Dhelmise: leParagon, Z-nogyroP
Nihilego: academico95, leParagon, fishbowlsoul90
Pheromosa: JaegerLucciano23, goranthegreat, leParagon
Necrozma (Normal): leParagon, HeXeR, mbcn10ww, AtecainCorp.
Melmetal: leParagon, French-Cyndaquil

Alolan Sandslash: zlolxd (front); Z-nogyroP (back)
Alolan Vulpix: Elazulmax, Versekr Dark, xiechayghe, goranthegreat, leParagon
Alolan Ninetales: leParagon (front); Z-nogyroP (back)
Alolan Persian: leParagon, OtaKun, xiechayghe
Ash-Greninja: N-Kin, Webobo, thedarkdragon11, capylus, MrDollSteak, leParagon
Zygarde (Complete): leParagon, MilanesaCosmica

Purple Kecleon: Chaos Rush, thedarkdragon11, GPX+
??? Arceus: Chaos Rush
Vivillon (All patterns): MrDollSteak, Golche, mbcn10ww, leParagon
Eternal Flower Floette: Ωmega
Furfrou (All trims): MrDollSteak, leParagon
Neutral Xerneas: N-Kin, leParagon

---------------------------

leParagon: Megax Rocker: All second frames except the ones below

MBCMechachu: Toucannon, Stufful, Bewear, Tapu Koko, Tapu Lele, Tapu Bulu, Tapu Fini, Cosmog, Lunala, All Pikachu in a hat forms; Busted Mimikyu, Zenith Marshadow custom first frames
Z-nogyroP: Crabrawler, Cutiefly, Ribombee, Mareanie, Araquanid, Sandygast, Palossand, Turtonator, Dhelmise
AlphaPro_25: Passimian
EndercreeperMugen: Normal Solgaleo
RousJuice and KrocF4: Guzzlord (includes fitting first frame)
MultiDiegoDani: Melmetal first frame fit
MrDollSteak, thedarkdragon11 and lee s.b: Ash-Greninja (second frame)
Eridanus: Shadow Lugia, Purple Kecleon, Primal Dialga custom first frames
leParagon: Galarian Stunfisk, Rotom Pokédex, Zygarde Cell and Core, Surfing and Flying Pikachu (both frames), QC for almost every icons
Percy: Nickit, Thievul, Sizzlipede, Centiskorch, Cursola, Milcery, Galarian Corsola, Galarian Darumaka
Just A Remixer: Eternatus (Normal)
Phasma: Grookey, Scorbunny, Sobble
shaugnmarc: Applin, Flapple, Appletun